XXXXX.XXXX.XXXXX
X..............X
X..............X
X..............X
X..............X
X..............X
X..............X
...............a
X..............X
X..............X
X..............X
X..............X
X..............X
X..............X
XXXXX.XXXX.XXXXX
