XXXXX.XXXX.XXXXX
X..............X
X..X........X..X
X..X........X..X
X..XXXX..XXXX..X
X..............X
X....XX..XX....X
...............a
X....XX..XX....X
X..............X
X..XXXX..XXXX..X
X..X........X..X
X..X........X..X
X..............X
XXXXX.XXXX.XXXXX
