XXXXX.XXXX.XXXXX
X..............X
X..............X
X...XXX..XXX...X
X...X......X...X
X...X......X...X
X......XX......X
.......XX.......
X...X......X...X
X...X......X...X
X...XXX..XXX...X
X..............X
X..............X
X..............X
XXXXX.XXXX.XXXXX
