..X...X...X...XX
.............XX.
X...........XX..
...........XX...
..........XX...X
.........XX.....
X.......XX......
.......XX.......
......XX.......X
.....XX.........
X...XX..........
...XX...........
..XX...........X
.XX.............
XX...X...X...X..
